1111111111111111111
11100E0000000C1
1110000000P0001
111111111111111
