111111111111
100000C00001
100000E00001
1000000P0001
111111111111