111111111111111
1110EC0000000C1
1110111000P0001
111111111111111
111111111111111
111111111111111
111111111111111
111111111111111
111111111111111
