111111
110001
100000C000P0000000000