1111111111111
1000000P00001
100000C000001
1000000C00E01
1111111111111