11111111111111111111111111111111111
10000111111000000000000000000000001
10000100001000000C000000P1000000001
10000100001111000000000000000000001
100001000010E0000000000000000000001
11111111111111111111111111111111111
