1111111111111
100E000100P01
100000C100001
1000000000001
1000000000101
1111111111111