11111111111111111111111111111111111
10000000000000000000000000000000001
10000000000000000000000000000000001
10000000000000000000000000000000001
10000000000000000000000000000000001
10000000000000000000000000000000001
10000000000000000000000000000000001
10000000000000000000000000000000001
10000000000000P00000000000000000001
100000000000000C000C000000000000001
10000000000000000000000000000000001
10000000000000000000000000000000001
10000000000000000000000000000000001
1000C00000000C000000000000000000001
10000000000000000000000000000000001
1000000000000000000E000000000000001
11111111111111111111111111111111111
