11111111111111111111111111111111111
10000000000000000000000000000000001
10000000000000000000000000000000001
10000000000000000000000000000000001
100000000000000C0000000000000000001
10000000000000000000000000000000001
10000000000000000000000000000000001
1000000C000000000000000000000000001
10000000000000P00000000000000000001
100000000000000C0000000000000000001
10000000000000000000000000000000001
10000000000000000000000000000000001
10000000000000000000000000000000001
10000000000000000000000000000000001
10000000000000000000000000000000001
1000000C00000000000EC00000000000001
11111111111111111111111111111111111
