1111111
1000P01
10E0001
1111111