1111111111111
100E000100P01
100000C100001
1111111111111
100P000000101
1111111111111
