1111111111111111111111111111
1111111111111111111111111111
1111111111111111111111111111
1111111111111111111111111111
1111111111111111111111111111
1000000000000000000000000001
100000000E00000C000000000001
1000000000000P00000000000001
1111111111111111111111111111